████████████████████
█         █        █
█  ██ ██  █  ████  █
█  ██ ██  █  ████  █
█                  █
█  ████      ████  █
█                  █
███ █   ███    █ ███
█   █ █  █  █  █   █
█   █ ██   ██  █   █
█     █  █  █      █
█  █    ███    █   █
█  █        █  █   █
█     ███████      █
█        █         █
█  ███   █    ███  █
█      █████       █
█     █  █  █      █
█        █         █
██████████████@@████

██##████████████████
█                  █
████ ███  ███ ███  █
█    █   █       █ █
█ █  █   █ █ █  ██ █
█                  █
█  █████   █████   █
█      █████       █
█    █   █   █     █
█  ███   █   ███   █
█    █ █   █ █     █
█  █     █     █   █
█  ██         ██   █
█  ██ ██ ██ █████  █
█ █   █  █     █   █
█  ██ █  ██  █ █  ██
█   █          █   █
█   █  ██  ██  █   █
█       █  █       █
██████████████@@████

██##████████████████
█                  █
█ ████████████████ █
█                  █
█ █ ████████████ █ █
█ █              █ █
█ █ █ ████████ █ █ █
█ █ █          █ █ █
█ █ █ █ ████ █ █ █ █
█ █ █ █      █ █ █ █
█ █ █ █      █ █ █ █
█ █ █ █ ████ █ █ █ █
█ █ █          █ █ █
█ █ █ ████████ █ █ █
█ █              █ █
█ █ ████████████ █ █
█                  █
█ ████████████████ █
█                  █
██████████████@@████

██##████████████████
█                ███
█    ██    ██      █
█ ██ ██ ██ ██ ██   █
█    ██    ██     ██
█ ██ ██ ██ ██ ██████
█    ██    ██      █
████ ██ ██ ██ ██   █
█                 ██
████ █████ ██ ██████
█    ██    ██      █
█ ██ ██ ██ ██ ██   █
█    ██    ██     ██
█ ██ ██ ██ ██ ██ ███
█    ██    ██      █
█ ██ ██ ██ ██ ██   █
█    ██    ██     ██
█ ██ ██ ██ ██ █  ███
█                 ██
████████████████████
